666666666666666
6s0000000000006
621122032222206
622221022244206
622221002244206
622222302222a06
625221102255206
625000202222206
622020002222206
621022121225206
611022522525a06
621011442222206
62302144p222206
6220000000000e6
666666666666666
