555555555555555
5s0000000000005
555555055555505
555555035555505
555555005555505
555555505555505
555555505555505
555000505555505
500000003555505
5a5555555555505
555555555555505
5555555555p5505
555555555505505
55z0000000000e5
555555555555555
