666666666666666
600000000000006
621122032222206
622221022244206
62222a002244206
62222220p222206
625221102255206
625000202222306
622020002222206
621022121225206
6110a2522525206
621011442222206
6210214422p2206
62300000s0000e6
666666666666666
