555555555555555
5000008000p8885
500000080008885
588880000008885
588880000008885
588880088800305
500000088800005
500s00088800005
500000088800005
588880000008805
588880000000005
588880030000005
588880088888805
5888803000000e5
555555555555555