111111111111111
122222222z22221
111122222222221
122222222222221
112222222222221
112222222221111
112122222222221
122222222111121
122122222222221
1211222222222e1
111222222222221
121122222221121
122222222222121
11s222222222121
111111111111111
