666666666666666
611111122z22216
611111122222216
611111111111216
611222111111216
611122111111216
611222222222216
611222222211116
622211222211116
6112111122222e6
611211111211116
622222222211116
621111211111116
6s1111111111116
666666666666666
