666666666666666
6888880z0888886
688800000008886
688800000008886
688800000008886
688000000000886
680000000000086
680000000000086
680000000000086
6880000000008e6
688800000008886
688800000008886
6888s0000008886
688888000888886
666666666666666