666666666666666
6555550z0555556
655500000005556
655500000005556
655500000005556
655000000000556
650000000000056
650000000000056
650000000000056
6550000000000e6
655500000005556
655500000005556
6555s0000005556
655555000555556
666666666666666
