666666666666666
622222222z22226
622222222222226
622222222222226
622222222222226
622222222222226
622222222222226
622222222222226
622222222222226
6222222222222e6
622222222222226
622222222222226
622222222222226
6s2222222222226
666666666666666
